%%%%%%%%%%%%%%%%%%%%
%                  %
%   o G % G o      %
%   G  % %  G      %
%   . %   % .      %
%   .%     %.      %
%   .%%%%%%%.      %
%   .%     %.      %
%   .%  P  %.      %
%                  %
%%%%%%%%%%%%%%%%%%%%
% % % % %%%%%%%%%%%%
%%%%%%%%%%%%%%%%%%%%